yamaha	_merk_motor_
yamaha vixion	_merk_motor_
etude house	_toko_kecantikan_
garuda indonesia	_maskapai_
honda vario	_merk_motor_
honda	_merk_motor_
beat	_merk_motor_
@lazadaid	_e-commerce_
atm bca	_atm_
@uber_idn	_transportasi_
@tcash_id	_e-money_
coffee bean	_cafe_
@YellowTruckCo	_cafe_
@sushi_ya	_cafe_
ocbc nisp	_bank_
lawson	_cafe_
folia	_merk_gamis_
btn	_bank_
@Qwordsdotcom	_web_hosting_
oxone	_perabot_
hsbc	_bank_
@MatahariMallCom	_department_store_
bca	_bank_
bni	_bank_
@LesFemmesBags	_toko_fashion_
cullote	_toko_fashion_
snowbay	_waterpark_
airasiago	_maskapai_
super indo 	_department_store_
santika	
amaris	